######################################
#     # ###        ##    ###  #      #
# ### # #     ### #### #  ##  # ###  #
#   # # # ##### #       #  ##  # # # #
# ### #   ##    #######  # #  # # #  #
#   # # # #  ## #      # # #    # #  #
# ### # # # #   # #### # # # ## # #  #
#   # # # # # ###    # # # #         #
# # # # ### # # #### # # #   #########
#   # #   # # #   ^  # # # # #       #
# # # ## ## # ## ##### # # #   ##### #
#   #     # #    #   # # # #####     #
# #########  ##### # ##  #       #####
#         ##       #    ## ####### # E
######### ################ #       # #
#         #            #     ####### #
# ######### ###### # # # #####       #
#   #   #   #      # # ### # # #######
# #   #   # # #### # #               #
######################################